B  ############################
      #     #        #  #     #
#  ####  #######  #  #  ####  #
#           #     #           #
#  #  ####  #######  #######  #
#  #  #           #  #  #     #
####  #######  #######  ####  #
#  #     #  #           #     #
#  ####  #  #  #######  ####  #
#        #        #        #  #
####  #  ####  ####  #######  #
#     #  #  #     #  #        #
####  ####  #  ##########  #  #
#           #  #           #  #
#  ####  ####  #######  #  #  #
#     #     #     #     #  #  #
#  #############  ####  #######
#     #        #        #     #
#  ##########  ####  #  #  #  #
#  #                 #     #  
############################  A