B  ####################################################################################################################################################
   #           #        #              #     #           #     #        #  #                 #  #              #  #                    #  #  #        #
#  #######  ##########  #  #  #############  #  ##########  ####  ####  #  ####  ####  #######  ####  ####  #  #  #  #  #############  #  #  #  #######
#           #  #           #     #              #        #           #  #     #  #  #     #     #     #     #     #  #     #  #  #  #  #  #           #
##########  #  #  #######  #######  ##########  #######  ####  ##########  ####  #  #  ####  #######  #  ####  ##########  #  #  #  ####  ####  #  ####
#     #              #     #           #     #           #  #     #  #     #  #  #  #     #  #        #     #           #     #  #  #  #  #     #  #  #
#  ##########  #  #############  ##########  ####  #######  #  #  #  ####  #  #  #  #######  #######  #######  #######  #  ####  #  #  #  #  #######  #
#     #        #  #           #  #  #                 #  #     #  #     #  #           #        #        #        #     #  #  #  #        #           #
#  #  #  #  ####  ####  #  #  #  #  #  ################  #  ##########  #  #  #  ####  #  #########################  ####  #  #  #######  #  #  #######
#  #     #     #     #  #  #  #  #        #        #  #           #        #  #     #     #     #  #  #     #        #  #     #     #        #        #
#  #############  ####  #  ##########  #  #  #  ####  ####  #############  ####  ####  #######  #  #  ####  #  #######  #  ####  #######  #  #  ####  #
#              #  #     #  #  #        #     #  #     #        #     #           #  #     #              #     #     #        #     #     #  #  #     #
#######  #############  ####  #######  #######  ####  #  #  ####  #############  #  ####  #  ####  #  ####  #######  #######  #  ####  ##########  ####
#              #              #  #     #     #  #     #  #  #        #     #  #  #           #     #           #  #  #     #  #  #     #  #     #     #
#############  #  ####  #######  ####  #  #  #######  ####  #  ####  ####  #  #  ####  ####  #############  ####  #  #  ####  #  #  ####  #  ##########
#  #  #           #     #  #  #           #                 #     #     #     #  #     #     #     #              #     #  #           #     #        #
#  #  #  #  #######  ####  #  #  #  #  #######  #######  ####  #############  ####  #  #  #  #  #  #  #  ##########  ####  ####  #  ####  #######  ####
#     #  #  #  #     #           #  #  #     #     #     #  #        #              #  #  #  #  #  #  #  #     #  #              #     #        #  #  #
#  #  #  ####  ####  #  ################  #######  ####  #  #  #  ##########  #  #  ####  #######  #  #  #  #  #  ####  #######  #######  #######  #  #
#  #        #     #     #     #        #     #     #           #              #  #  #           #     #     #           #           #     #  #     #  #
#  #  #  #  #  ##########  ####  #######  #  ##########  ####  #  #  ####  #############  ##########  ####  ####  #  #######  ####  #  ####  #  #  #  #
#  #  #  #  #     #  #  #              #  #  #  #  #        #  #  #  #           #        #  #  #  #     #  #     #  #     #     #        #     #     #
####  #######  ####  #  ##########  ####  ####  #  ####  #############  ###################  #  #  ####  #  ##########  #  #  ##########  #  ####  #  #
#              #           #  #  #           #     #     #  #     #  #  #           #  #  #  #           #  #  #  #     #              #        #  #  #
#  ####  #######  ##########  #  ####  ####  #  #######  #  ####  #  #  #######  ####  #  #  #  #  #  #  ####  #  ####  #  #  #######  ####  #######  #
#     #  #     #           #     #     #        #  #        #        #     #     #     #     #  #  #  #     #  #  #  #  #  #  #     #  #     #        #
##########  ####  ##########  #  ####  #  #######  ####  ####  ####  #  ####  #  ####  #  ###################  #  #  ####  #  #  ####  #  #  #######  #
#  #              #           #     #  #     #  #        #        #  #  #     #  #                    #     #     #  #     #        #  #  #  #     #  #
#  ##########  ##########  ####  #  #  #######  #  ##########  #  #############  ####  ####  #  ####  ####  ####  #  ######################  #  ####  #
#     #  #  #                 #  #        #  #  #  #     #  #  #     #        #     #  #     #  #     #     #     #           #        #     #        #
#  ####  #  ####  ##########  #############  #  ####  #  #  #  ####  #######  #  ##########  #  #  ####  ####  #  ####  ####  #  #############  ####  #
#     #     #     #     #        #        #        #  #        #        #        #           #  #     #     #  #     #  #  #  #     #           #  #  #
####  #  #######  #  #  ####  #  #  #######  #######  ####  ##########  ####  #############  ####  ####  ####  ####  #  #  ####  ####  #  #  ####  #  #
#        #        #  #        #                       #  #     #           #  #                 #           #     #     #              #  #     #  #  #
#  ####  ####  #  #  ##########  #  ####  #######  #  #  #############  ####  #######  #############  #  ##########  ################  ####  #  #  #  #
#  #        #  #  #  #           #  #        #     #        #     #                 #     #        #  #                 #     #  #  #  #  #  #     #  #
#  ####  ##########  #  #########################  #######  ####  #  ####  ####  #  #  ####  #######  #######  ####  ####  #  #  #  #  #  #  #  #######
#  #              #  #           #  #     #           #        #        #     #  #        #     #  #     #     #  #     #  #        #  #     #        #
#  ####  ################  #######  ####  ####  #############  #######  #######  ####  ####  ####  ##########  #  #  ##########  #  #######  ####  ####
#  #                 #        #     #        #  #        #           #     #     #     #        #     #     #     #  #     #     #     #        #     #
#  #######  ######################  ####  #############  #  ####  ####  #############  ####  ####  #######  #  ####  #  #  #  #  #  ####  #  #  #  ####
#  #              #           #                 #              #  #     #  #        #     #  #           #     #  #     #     #  #        #  #  #  #  #
#  ##########  #############  ####  ######################  ####  #  ####  ####  #######  #  #  ####  ####  ####  #  ####  ####  #######  ##########  #
#  #                    #  #        #     #  #              #     #        #     #  #     #        #  #  #        #  #     #        #                 #
#  ####  #############  #  ####  #  ####  #  #######  ##########  ####  #  #  #  #  #  #  ####  #######  ################  ####  #  #  ####  ####  #  #
#     #  #           #     #     #        #     #        #        #  #  #  #  #     #  #  #                       #  #     #  #  #  #  #        #  #  #
####  ####  #######  #  ##########  #  #  #  ####  #######  #  #  #  #############  #  #  #  #  #######  ####  ####  #  ####  #############  ####  #  #
#        #  #  #              #  #  #  #        #     #     #  #  #  #     #  #  #     #  #  #        #  #     #     #           #     #        #  #  #
#  ##########  #  #  #  #  ####  ####  ####  #  ####  #######  ####  #  ####  #  ####  #  #######  #############  ####  #######  ####  #  #  #  ####  #
#  #     #     #  #  #  #  #  #  #     #  #  #     #     #  #     #  #           #  #  #  #  #     #  #     #     #        #     #  #  #  #  #  #     #
#  #  #######  #######  ####  #  ####  #  #############  #  #  #  #  ##########  #  ####  #  ####  #  ####  #  #  #  #############  #  #  ####  ####  #
#           #           #  #     #  #  #        #     #     #  #  #  #     #        #        #        #  #  #  #     #     #                 #     #  #
#######  #  #  ##########  ####  #  #  #  #######  #  ####  ####  #  ####  #######  #######  ####  ####  #  #  #  ####  ##########  #############  ####
#        #  #           #        #        #        #  #     #  #  #  #           #     #     #     #           #  #     #        #  #  #  #     #  #  #
####  #  #  #  #######  #  ####  ####  ####  ####  ####  ####  #  #  #######  ####  ####  ####  ################  #  ##########  #  #  #  #  #  ####  #
#     #  #  #  #     #  #     #  #        #  #  #        #  #        #     #        #  #        #           #                 #     #        #     #  #
#  ##########  #  #  #######  ####  #  #  ####  ##########  #  #  #  #  ####  #######  ####  #############  ####  ####  #######  #  #  #  ####  #  #  #
#           #     #  #  #  #        #  #  #  #  #           #  #  #        #              #        #     #           #        #  #     #  #     #     #
################  #  #  #  ##########  ####  #  #######  ####  #  #######  ####  ####  #  #  ##########  #  ####  #  ################  #######  #######
#  #  #  #        #  #        #              #              #  #  #           #  #     #     #  #        #  #  #  #        #     #  #     #  #  #     #
#  #  #  #######  ##########  #######  #######  #  ####  #  ####  ####  ####  #  ####  #######  ####  #  ####  #  ##########  ####  #  ####  ####  #  #
#     #  #        #  #        #  #        #  #  #  #     #  #        #  #  #  #     #                 #  #        #  #              #  #     #     #  #
#  ####  ####  ####  ####  ####  #  #  ####  ####  ####  #############  #  ####  ################  #  ##########  #  ####  ####  #######  #######  ####
#     #        #  #  #     #  #     #           #  #  #  #  #     #  #     #           #     #  #  #  #     #  #  #     #  #  #     #     #  #        #
####  ####  ####  #  #  ####  ####  #######  ####  #  ####  #  ####  #######  #######  #  #  #  #  #  ####  #  #######  ####  ####  ####  #  #######  #
#           #  #  #  #              #  #              #     #  #                    #  #  #  #     #        #  #                       #  #     #     #
#######  ####  #  #  #  #############  ####  #  #  #  #  #  #  #  ################  #  #  ####  #######  ####  #  #  #  #  #  #######  #  #  ####  #  #
#        #  #     #     #     #  #     #     #  #  #  #  #     #     #  #  #        #  #              #  #        #  #  #  #  #  #  #     #     #  #  #
#  #######  ####  ####  #  #  #  #  #  ####  ##########  #  ##########  #  #  #  #######  #  #############  #  #  #######  ####  #  #######  ####  ####
#  #           #     #  #  #        #                    #        #     #     #  #  #  #  #  #     #     #  #  #     #  #  #  #        #     #     #  #
#  #  ####  #######  #  ####  #  #############  #######  ##########  #  #  #  #  #  #  ####  #  #  ####  ####  #######  ####  #######  #  #######  #  #
#        #           #  #     #           #     #           #        #  #  #  #  #              #  #        #           #     #     #        #  #     #
###################  #  #  ##########  #  #  #######  #############  #######  #  ##########  ####  #  #######  ####  #  ####  ####  ####  ####  #  ####
#  #     #        #     #  #        #  #  #  #                 #     #  #  #  #  #  #        #                    #  #        #  #                    #
#  ####  ####  #######  ####  #  #  ####  ####  #######  ####  #  ####  #  ####  #  #  #######  #######  #  #  #  #######  ####  ####  #############  #
#           #        #  #  #  #  #        #           #  #  #              #        #     #  #  #        #  #  #     #     #        #  #           #  #
##########  ####  #  ####  #######  ####  #  #  #  #######  ####  ####  ####  #######  ####  #  #  ####  ####  #######  #######  #  #  #  ####  ####  #
#     #           #        #     #     #  #  #  #     #              #     #  #              #  #  #     #  #  #     #     #     #     #  #           #
#  #######  ###################  ####  #  ################  #############  ####  #  ####  #######  #  ####  #  ####  #  ##########  #  ####  ##########
#     #        #     #     #        #  #  #  #        #     #     #           #  #  #  #  #        #        #  #  #     #           #     #        #  #
#  ####  ####  ####  ####  #  #######  ####  #  ####  #  ####  #  #  #######  #######  ###################  #  #  #  #######  #  #  #######  #  ####  #
#     #     #  #     #              #  #     #  #  #  #  #  #  #  #  #  #  #  #     #        #     #     #  #     #        #  #  #        #  #  #     #
####  ####  ####  ####  #######  ####  ####  ####  #  ####  ####  #  #  #  #  #  #######  ####  #######  #############  #######  #  ####  #  ####  ####
#  #                       #  #        #                 #  #  #  #  #                    #     #  #     #        #     #  #     #  #  #  #  #        #
#  #######  #  #  #######  #  #  #  #######  #  ##########  #  #  #  #  #######  ####  ####  #  #  ####  #  #######  ####  #######  #  #######  #  #  #
#  #  #  #  #  #     #  #     #  #  #     #  #  #     #  #  #  #     #  #  #        #  #     #  #           #              #                 #  #  #  #
#  #  #  ####  ####  #  #######  #  ####  ####  #  ####  #  #  #  #  ####  ####  #  #  #  #  ##########  #  #######  ####  #  #######  #  ##########  #
#           #     #  #           #              #  #  #        #  #  #     #  #  #  #     #  #     #     #     #     #  #     #        #              #
##########  #  ####  ####  #  #######  ####  #  #  #  #######  #  #  #  #  #  #  #  #######  ####  ####  ####  #  ####  #  ####  ####  ####  ##########
#  #              #  #     #  #  #        #  #              #     #  #  #        #     #     #              #           #  #  #     #     #        #  #
#  ###################  #######  ####  ##########  #######  #  #  #  ###################  #  ##########  #######  #  #######  #######  #  ##########  #
#  #              #              #              #  #     #  #  #  #     #        #     #  #     #           #     #  #     #           #              #
#  #  ##########  #  ####  ####  #######  #######  #  ################  #  ##########  #  #######  ##########  ##########  ####  ####  ##########  ####
#  #     #        #  #  #  #        #  #        #     #     #     #        #  #        #  #           #                       #     #  #  #  #        #
#  #  ##########  #  #  #######  ####  #  ####  #######  ####  ####  #  #  #  ####  ####  ####  #  ####  #######  #  ###################  #  ####  #  #
#     #        #  #     #  #        #  #  #  #  #        #  #  #  #  #  #        #     #        #  #     #        #  #     #        #  #     #     #  #
##########  #  #  #  ####  #  #  ####  #  #  ####  #  ####  #  #  ####  #  ####  #  ####  #############  ####  ####  ####  #  ####  #  ####  #######  #
#     #     #           #     #     #        #     #        #           #     #     #     #           #  #     #           #     #        #           #
#  #  #  ####  ####  #######  ################  #  #  #  #  #  ##########  ####  #######  #######  ##########  #  #######  ####  ####  #  ##########  #
#  #     #     #     #                 #        #  #  #  #           #        #     #                 #        #        #     #  #     #              
####################################################################################################################################################  A